NO ./assets/wall.xpm
SO ./assets/cat.xpm
WE ./assets/shrek.xpm
EA ./assets/floor.xpm

F 7,8,33
C 0,0,0

        1111111111111111111111111
111     1000000000110000000000001
101     10110000011100000000000011111
101     100100000000000010000000000011
1011111110110000011100000000000011101
1000000000100000111011111111111111101
11110111111111011100000010001     101
1111011101111101110101001001      111
1100000011010101110000000001
100000000000N0000000000000011
1010000000000000000010100001
1000000111010101111101111000111
10010111 1110101 101111010001
11011111 1111111 111111110101
 101                     1101111
 101                      100001 
 111                      111111
