NO ./assets/wall.xpm
SO ./assets/cat.xpm
WE ./assets/shrek.xpm
EA ./assets/floor.xpm

F 7,8,33
C 0,0,0

        1111111111111111111111111
        1000000000110000000000001
        1011000001110000000000001
        10010000000000001000000011
111111111011000001110000000000001
10000000011000001110111111111111
11110111111111011100000010001
1111011101111101110101001001
1100000011010101110000001001
100000000000N0001100000010011
1010000000000000011010100101
1000000111010101111101111000111
10110111 1110101 101111010001
11111111 1111111 11111111011
                         1
