
NO ./assets/camorange.xpm
SO ./assets/floor.xpm
WE ./assets/camored.xpm
EA ./assets/camogreen.xpm

F 3,5,32
C 0,0,0

        1111111111111111111111111
        1000000000110000000000001
        1011000001110000000000001
        1001000000000000000000001
111111111011000001110000000000001
100000000011000001110001111111111
11110110011111111100000010001
11110110011111 1101010010001
11000000110101111100000010001
10000000000000001100000010001111111111111111111111111111111111111111111111111111111111111111111111111111111111111
10000N00000000000000000000000000000000000000000000000000000000000000000000000000000000000000000000000000000000001
 100000000000100000000000000000000000000000000000000000000000000000000000000000000000000000000000000000000000001
  10001000001 100000000000000000000000000000000000000000000000000000000000000000000000000000000000000000000000001
 10001 100000100000000000000000000000000000000000000000000000000000000000000000000000000000000000000000000000001
1000001000000001100000000011111111111111111111111111111111111111111111111111111111111111111111111111111111111111
10000000000000000000100001
10000001111101111111111111
 101111     1
  1 



