
NO ./assets/camorange.xpm
SO ./assets/floor.xpm
WE ./assets/camored.xpm
EA ./assets/camogreen.xpm

F 3,5,32
C 0,0,0

        1111111111111111111111111
        1000000000110000000000001
        1011000001110000000000001
        1001000000000000000000001
111111111011000001110000000000001
100000000011000001110111111111111
11110111111111111100000010001
11110111111111 1101010010001
11000000110101111100000010001
10000000000000001100000010001111111111111111111111111111111111111111111111111111111111111111111111111111111111111
10000000000000000000000000000000000000000000000000000000000000000000000000000000000000000000000000000000000000001
 1000000000000100000000000000000000000000000000000000000000000000000000000000000000000000000000000000000000000001
10000000000001 100000000000000000000000000000000000000000000000000000000000000000000000000000000000000000000000001
10000000000000100000000000000000000000000000000000000000000000000000000000000000000000000000000000000000000000001
10000000000000001100000010001111111111111111111111111111111111111111111111111111111111111111111111111111111111111
1000000N0000000001101010010001
1100000111010101111101111000111
11110111 1110101 101111010001
11111111 1111111 111111111111



