F 220,100,0
EA ./path_to_the_east_texture
C 225,30,0
NO ./path_to_the_north_texture
WE ./path_to_the_west_texture
SO ./path_to_the_south_texture






       11111111111     
1111111000000001111111
1111111000000001111111111      1111
11111000000N0000111111111      1001
1111000000011110000111111      1111
1110000011100111111111001
1111101111111111111111111