F 255,255,0
C 255,255,255
EA ./assets/camored.xpm
NO ./assets/floor.xpm
WE ./assets/camorange.xpm
SO ./assets/wall.xpm

1111
1001
10N1
1111
