F  255,0,0 
C  255,255,255
EA ./assets/wall.xpm
NO ./assets/wall.xpm
WE ./assets/wall.xpm
SO ./assets/wall.xpm

111
   1111
1N11