F 255,255,0
C 255,255,255
EA ./assets/wall.xpm
NO ./assets/floor.xpm
WE ./assets/wall.xpm
SO ./assets/wall.xpm

11111111
10000001
10011101
1001N101
10011101
11111111
