F 220,100,0
EA ./lol.xpm
C 225,30,0
NO ./lol.xpm
WE ./lol.xpm
SO ./lol.xpm

       11111111111     
1111111000000001111111
1111111000000001111111111      1111
11111000000N0000111111111      1001
1111000000011110000111111      1111
1110000011100111111111001
1111111111111111111111111