F 220,100,0
EA ./path_to_the_east_texture
C 225,30,0
NO ./path_to_the_north_texture
WE ./path_to_the_west_texture
SO ./path_to_the_south_texture

11111
  1N111
111 111